+--+--+--+--+
|     |     |
+  +--+  +  +
|  |     |  |
+  +--+--+  +
|  |     |  |
+  +  +--+  +
|     |     |
+--+--+--+--+