+--+--+--+--+
|           |
+  +  +--+  +
|  |  |     |
+  +  +  +--+
|  |  |     |
+  +  +--+  +
|          w|
+--+--+--+--+