+--+--+--+--+
|     |     |
+  +--+  +  +
|  |     |  |
+  +--+  +  +
|  |     |  |
+  +  +--+  +
|    w|     |
+--+--+--+--+