+--+--+--+--+
|p          |
+  +  +--+  +
|  |  |     |
+  +  +  +--+
|  |  |     |
+  +  +--+  +
|          g|
+--+--+--+--+